                                     #######         
                                  ###########        
                                  ###########        
  #######                         ###########        
 ##########                        ##########        
 ##########                            ######        
 #########################################           
 #########################################           
 #########################################           
 #########                             ###           
   ######                              ###           
    ####                               ###           
    ####                               ####          
    ####                               ###           
    ####                               ###           
    ####                             ############### 
###########                        ################# 
############    #######          ####################
############ ########################################
################         ############################
###############                    ##################
###########                          ################
###########                             ######       
###########                             ####  
                                     #######                                                  
                                  ###########                                                 
                                  ###########                           ################      
  #######                         ###########                          ##################     
 ##########                        ##########                         ####################    
 ##########                            ######                         #####################   
 #########################################                            ########################
 #########################################                            ########################
 #########################################                            ########################
 #########                             ###                            ######################  
   ######                              ###                            ######################  
    ####                               ###                             #####################  
    ####                               ####                            ##################     
    ####                               ####                            ###                    
    ####                               ####                            ###                    
    ####                             ###############                   ###                    
###########                        #################                   ###                    
############    #######          ####################                  ###                    
############ ##############################################            ###                    
################         #####################################################                
###############                    ############################################               
###########                          ################               ###########               
###########                             #############               ###########               
###########                                     ######               #########                
  ###                                             ######                  ####                
  ###                                               ######                ###                 
  ###                                                #######             ####                 
  ###                     ########                    #######           ###                   
  ###                    ###########                    #####          ####                   
 ####                    ##      ####                    #####         ###                    
 ####                    ###     ####                      ########## ###                     
 ####                     ###########                       ###########                       
 ####                     ########                          #############                     
############            ######                             ################                   
#################     #######                              ##################                 
###########################                                ##################                 
########################                                    #################                 
######################                                           ############                 
####################                                                 # ###                    
####################                                                                          
####################                                                                          
           ##############                                                                     
               ##########                                                                     
                    #########  #######                                                        
                        ##############                                                        
                         #############                                                        
                         #############                                                        
                          ############                                                        
                          #########                                                           
                          ########                                                            
                           ######                                                             
                             ###                                                              