                                   ####            
                                #########          
                                #########          
                                #########          
    ###                          ########          
  #######                            ####          
 #########                           ###           
 #######################################           
 #######################################           
 #######                             ###           
  #####                              ###           
   ##                                ###           
   ##                                ####          
   ##                                ###           
   ##                                ###           
   ##                              ############### 
 ########                        ################# 
##########    #######          ####################
########## ########################################
##############         ############################
 ############                    ##################
                                   ################
                                      ######       